82 65
6656665566666656666656666666666666666666666666666666666666666666666666666666666666
6656656665665666566666666666666666666666666666666666666666666666666666666666666666
66aaaaaaaaaaaa66666666666666666666666666666666666666666666666666666666666666666666
66a8888a88888a66666666666666666666666666666666666666666666666666666666666666666666
66a8888a88888a66666666655666666666666666666666666666666666666666666666666666666666
66a8888a88888a66666666666666666666666666666666666666666666666666666666666666666666
66a8888a88888a66666666666666666666666666666666666666666666666666666666666666666666
66a8888a88888a65566666666666666666666666666666666666666666666666666666666666666666
66a8aaaaaaaa8a66665656666666666666666666666666666666666666666666666666666666666666
66a8888888888a56665666666666666666666666666666666666666666666666666666666666666666
66a8888888888a56666666666666666666666666666666666666666666666666666666666666666666
66a8888888888a65666666666666666666666666666666666666666666666666666666666666666666
56a8888888888a66666666666666666666666666666666666666666666666666666666666666666666
66aaaaa88aaaaa66656666666666666666666666666666666666666666666666666666666666666666
666656a88a666666656666666666666666666666666666666666666666666666666666666666666666
565666a88a666666666556566666666666666666666666666666666666666666666666666666666666
6aaaaaa88aaaaaa6666666666566666666666666666666666666666666666666666666666666666666
6a888888888888a6656656656666666666666666666666664444444444666666666666666666666666
5a888888888888a6666665666666666666666666666666664444444444666666666666666666666666
6a888888888888a6566665666666666666666666666666664466666644666666666666666666666666
6a888888888888a6666656665666666666666666666666664466666644666666666666666666666666
6a888888888888a6565665665666666666666666666666444444444444444444666666666666666666
6a888888888888a6666666665666666666666666666666444444444444444444666666666666666666
6aaaaaaa6aaaaaa6666666666666666666666666666666444444444444444444666666666666666666
6bbbbbbb6bbbbbb6666666666666666666666666666666444444444444444444666666666666666666
6666666666666666666666666666666666666666664444444444444444444444666666666666666666
6666666666666666666666666666666666666666664444444444444444444444666666666666666666
6666666666666666666666666666666666666666664455444444444444444444666666666666666666
6666666666666666666666666666666666666666664455444444444444444444666666666666666666
6666666666666666666666666666666666666666444455444444444444444444666666666666666666
6666666666666666666666666666666666666666444455444444444444444444666666666666666666
6666666666666666666666666666666666666666666666xxxxxxxxxxxxx44666666666666666666666
6666666666666666666666666666666666666xxxxxxxxxxxxxxx666xxxx44666666666666666666666
6666666666666666666666666666666666665x44444444444444x66x44444444666644444444446666
6666666666666666666666666666666666665x44444444444444x66x44444444666644444444446666
6666666666666666666666666666666666665x445544xxxx5544x66x44666644445544666655446666
bb999bb999bb999bbx6666666666666666665x445544xxxx5544x66x44666644445544666655446666
x5999559996599966x6666666666666666665x44554444xx4444x66x44446666445544554444446666
x5999569995599956x6666666666666666665x44554444xx4444x66x44446666445544554444446666
x6999559996599966x6666666666666666665x44666644x6xxxx666xxx446666666644554466666666
x4444444444444446x6666666666666666665x44666644xxxxxxx6666x444444666644554466666666
x3333333333333346x666666666666xxxxxxxx44554444444444x6665x444444666644554455446666
x3333333333333346x66666666665x4444444444554444444444x6665x445544444444554455446666
x3333333333333346x6666666666x444444444445544xxxxxx44xxxxxx445544444444554444446666
x4444444444433346x666666666x4446666666445544x66x4444xx4444446666666666664444446666
x6655665565433346x66666666x44466666666445544x66x4444xx4444446666666666664466666666
x6665655656433346x6666666x444666666665445544xxxxxxxxxx4455446666666666664466666666
x5655655665433346x666666x444666666665544554444444444444455444444666444444444444666
x6665566556433346x66666x4446666666666644554444444444444455444444666444444444444666
x5656556565433346x6666x44466666666666644666666666666666666666666666666666666644666
x6566666655433346x666x444666666666666544444444444444444444444444444444666666644666
x6666666666433346x66x4446666666666666644444444444444444444444444444444666666666666
x4444444444433346x6x44466666666666666543333333333333333333333333333334666666666666
x3333333333333345xx444666666666666665543331111111111111111111111113334666666666666
x3333333333333346x4446666666666666666643333333333333333333333333333334666666666666
x333333333333334444466666666666666666643234444444444444444444444443234666666666666
x444444444444444444466666666666666666643234666666666666666666665543234666666666666
x444444444444444444466666666666666666643234666666666666666666665543234666666666666
x444444444444444444466666666666666666643234666666666666666666665543234666666666666
x444444444444444444466666666666666666643234666666666666666666665543234666666666666
x444444444444444444466666666666666666643234666666666666666666665543234666666666666
x444444444444444444466666666666666666643234666666666666666666665543234666666666666
x444444444444444444466666666666666666643234666666666666666666665543234666666666666
x444444444444444444466666666666666666643234666666666666666666665543234666666666666
x444444444444444444466666666666666666643234666666666666666666665543234666666666666