118 58
6656665566666655666656666666666666666666666666666666666666666666666666666666666666666666666666666666666666666666666666
6656656665665666566666666666666666666666666666666666666666666666666666666666666666666666666666666666666666666666666666
66aaaaaaaaaaaa66666666666666666666666666666666666666666666666666666666446666656666666666666666666666666666666666666666
66a8888a88888a66666666666666666666666666666666666666666666666666666666446666666666666666666666666666666666666666666666
66a8888a88888a66666666655666666666666666666666666665666666666666666666446666666666666666666666666666666666666666666666
65a8888a88888a66666666666666666666666666666666444444444444666666666666446666666666666666666666666666666666666666666666
66a8888a88888a66666666666666666666666666666666444444444444666666666666446666666666666666666666666666666666666666666666
66a8888a88888a65566666666666666666666665666666446666666644666666666666446666666666666666666666666666666666666666666666
66a8aaaaaaaa8a66665656666666666666666666666666446666666644444444444444444444444444446666666666666666666666666666666666
66a8888888888a56665666666656666666666666666666446666666644444444444444444444444444446666666666666666666666666666666666
66a8888888888a56666666666666666666666666666666446666666644666666666666666666446666446666666666666666666666666666666666
56a8888888888a65666666566666666666666666666666446666666644666666666666666666446666446666666666666666666666666666666666
56a8888888888a66666666666666666666666666666666446666665644666666666666666666446666444466666666666666666666666666666666
66aaaaa88aaaaa66656666666666666666666666666666446666666644666666666666666666446666444466666666666666666666666666666666
666656a88a666666656666666666666666666666666666446666666644665666666666666666446666446666666666666666666666666666666666
565666a88a666666666556566666666666666666666666446666666644666666666666666666444444446666666666666666666666666666666666
6aaaaaa88aaaaaa6666666666566666666666666666666446666666644666666666666666666444444446666666666666666666666666666666666
6a888888888888a6656656656666666666666666666666446666666644666666666666666666666666666666666666666666666666666666666666
5a888888888888a6666665666666666666666666666666446666666644666666666666666666666666666666666666666666666666666666666666
6a888888888888a6566665666666656666666666666666446666666644666666666666666666666666666666666666666666666666666666666666
6a888888888888a6666656665666666666666666666666446666666644666666666666666666666666666666666666666666666666666666666666
6a888888888888a65656656656666666666666666666664444a4444444444444666666666666666666666666666666666666666666666666666666
6a888888888888a66666666656666666666666656666664444a4444444444444666666666666666666666666666666666666666666666666666666
6aaaaaaa6aaaaaa66666666666666666666666666666664444a4444444444444666666666666666666666666666666666666666666666666666666
6bbbbbbb6bbbbbb6666666666666666666666666666666bbbba4444444444444666666666666666666666666666666666666666666666666666666
6666666666666666666666666666566666666666664444444444444444444444666666666666666666666666666666666666666666666666666666
6666666666666666666666666666666666666666664444444444444444444444666666666666666666666666666666666666666666666666666666
6666666666666666666666666666666666666666664456444444444444444444566666666666666666666666666666666666666666666666666666
6666666666666666666666666666666666666666664465444444444444444444666666666666666666666666666666666666666666666666666666
6666666666666666666666666666666666666666444466444444444444444444666666666666666666666666666666666666666666666666666666
6666666666666666666666666666666666666666444466444444444444444444666666666666666666666666666666666666666666666666666666
6666666666666666666666666666666666666666666666666666666666644666666666666666666666666666666666666666666666666666666666
6666666666666666666666666666666666666666666666666666666666644666666666666666666666666666666666666666666666666666666666
6666666666666666666666666666656666666644444444444444666644444444666644444444446666666666666666666666666666666666666666
6666666666666666666666666666666666666644444444444444666644444444666644444444446666666666666666666666666666666666666666
5666666666666666666666666666666666666644664466666644666644666644446644666666446666666666666666666666666666666666666666
bb999bb999bb999bb66666666666665666666644664466666644666644666644446644666655446656666666666666666666666666666666666666
5599955999659996666666666666666666666644554444554444666644446666446644554444446666666666666666666666666666666666666666
6599956999559995666666666666666666665544664444664444666644446666446644664444446666666666666666666666666666666666666666
5599966999659996666666666666666666666644666644666666666666446666666644664466666666666666666666666666666666666666666666
4444444444444444666666666666666666666644666644666666666666444444666644664466666666666666666666666666666666666666666666
4333333333333334666666656666666666666644664444444444666666444444666644664466446666666666666666666666666666666666666666
4333333333333334666666666666664444444444664444444444666666446644444444664466446666666666666666666666666666666666666666
4333333333333334666666666666544444444444664466666644666666446644444444664444446666666666666666666666666666666666666666
4444444444443334666666666666444666666644664466664444664444446666666666664444446666666666666666666666666666666666666666
6666666666543334666666666664446666666644664466664444664444446666666666664466666666666666666666666666666666666666666666
6666566665643334666666666644466666666544664466666666664466446666666666664466666666666666666666666666666666666666666666
6566666666543334666666666444666666566644664444444444444466444444666444444444444446666666666666666666666666666666666666
6666666666643334666666664446666666666644564444444444444466444444666444444444444446666666666666666666666666666666666666
6665666656543334666666644466666666666644666666666666666666666665666666666666666446666666666666666666666666666666666666
565666666664333466666644466666666666654444444444444444444444444444444466666666a44aaaaa66666666666666666666666666666666
666666666664333466666444666666666666664444444444444444444444444444444466666666a444444a66666666666666666666666666666666
444444444444333466664446666666666666654333333333333333333333333333333466666666a444444a66666666666666666666666666666666
333333333333333456644466666666666666664333111111111111111111111111333466666666a444444a66666666666666666666666666666666
333333333333333465444666666666666666664333333333333333333333333333333456666666a444444a66666666666666666666666666666666
333333333333333444446666666666666666664323444444444444444444444444323466666666a444444a66666666666666666666666666666666
444444444444444444446666666666666666664323466666666666666666666664323466666665a444444a66666666666666666666666666666666
666666666666666666666666666666666666664323466666666666666666666664323466666666aaaaaaaa66666666666666666666666666666666