86 58
66566655666666556666566666666666666666666666666666666666666666666666666666666666666666
66566566656656665666666666666666666666666666666666666666666666666666666666666666666666
66aaaaaaaaaaaa666666666666666666666666666666666666666666666666666666664466666566666666
66a8888a88888a666666666666666666666666666666666666666666666666666666664466666666666666
66a8888a88888a666666666556666666666666666666666666656666666666666666664466666666666666
65a8888a88888a666666666666666666666666666666664444444444446666666666664466666666666666
66a8888a88888a666666666666666666666666666666664444444444446666666666664466666666666666
66a8888a88888a655666666666666666666666656666664466666666446666666666664466666666666666
66a8aaaaaaaa8a666656566666666666666666666666664466666666444444444444444444444444444466
66a8888888888a566656666666566666666666666666664466666666444444444444444444444444444466
66a8888888888a566666666666666666666666666666664466666666446666666666666666664466664466
56a8888888888a656666665666666666666666666666664466666666446666666666666666664466664466
56a8888888888a666666666666666666666666666666664466666656446666666666666666664466664466
66aaaaa88aaaaa666566666666666666666666666666664466666666446666666666666666664466664466
666656a88a6666666566666666666666666666666666664466666666446656666666666666664466664466
565666a88a6666666665565666666666666666666666664466666666446666666666666666664444444466
6aaaaaa88aaaaaa66666666665666666666666666666664466666666446666666666666666664444444466
6a888888888888a66566566566666666666666666666664466666666446666666666666666666666666666
5a888888888888a66666656666666666666666666666664466666666446666666666666666666666666666
6a888888888888a65666656666666566666666666666664466666666446666666666666666666666666666
6a888888888888a66666566656666666666666666666664466666666446666666666666666666666666666
6a888888888888a65656656656666666666666666666664444a44444444444446666666666666666666666
6a888888888888a66666666656666666666666656666664444a44444444444446666666666666666666666
6aaaaaaa6aaaaaa66666666666666666666666666666664444a44444444444446666666666666666666666
6bbbbbbb6bbbbbb6666666666666666666666666666666bbbba44444444444446666666666666666666666
66666666666666666666666666665666666666666644444444444444444444446666666666666666666666
66666666666666666666666666666666666666666644444444444444444444446666666666666666666666
66666666666666666666666666666666666666666644564444444444444444445666666666666666666666
66666666666666666666666666666666666666666644654444444444444444446666666666666666666666
66666666666666666666666666666666666666664444664444444444444444446666666666666666666666
66666666666666666666666666666666666666664444664444444444444444446666666666666666666666
66666666666666666666666666666666666666666666666666666666666446666666666666666666666666
66666666666666666666666666666666666666666666666666666666666446666666666666666666666666
66666666666666666666666666666566666666444444444444446666444444446666444444444466666666
66666666666666666666666666666666666666444444444444446666444444446666444444444466666666
56666666666666666666666666666666666666446644666666446666446666444466446666664466666666
bb999bb999bb999bb666666666666656666666446644666666446666446666444466446666554466566666
55999559996599966666666666666666666666445544445544446666444466664466445544444466666666
65999569995599956666666666666666666655446644446644446666444466664466446644444466666666
55999669996599966666666666666666666666446666446666666666664466666666446644666666666666
44444444444444446666666666666666666666446666446666666666664444446666446644666666666666
43333333333333346666666566666666666666446644444444446666664444446666446644664466666666
43333333333333346666666666666644444444446644444444446666664466444444446644664466666666
43333333333333346666666666665444444444446644666666446666664466444444446644444466666666
44444444444433346666666666664446666666446644666644446644444466666666666644444466666666
66666666665433346666666666644466666666446644666644446644444466666666666644666666666666
66665666656433346666666666444666666665446644666666666644664466666666666644666666666666
65666666665433346666666664446666665666446644444444444444664444446664444444444444466666
66666666666433346666666644466666666666445644444444444444664444446664444444444444466666
66656666565433346666666444666666666666446666666666666666666666656666666666666664466666
565666666664333466666644466666666666654444444444444444444444444444444466666666a44aaaaa
666666666664333466666444666666666666664444444444444444444444444444444466666666a444444a
444444444444333466664446666666666666654333333333333333333333333333333466666666a444444a
333333333333333456644466666666666666664333111111111111111111111111333466666666a444444a
333333333333333465444666666666666666664333333333333333333333333333333456666666a444444a
333333333333333444446666666666666666664323444444444444444444444444323466666666a444444a
444444444444444444446666666666666666664323466666666666666666666664323466666665a444444a
666666666666666666666666666666666666664323466666666666666666666664323466666666aaaaaaaa